3 2 2 3 2 3
1 0 0 1 5 1
1 0 2 3 0 1
1 0 0 0 0 3
1 5 4 1 0 1
3 2 2 3 4 3