3 2 3 2 2 2 2 2 2 2 2 3
1 0 1 0 0 0 0 5 3 4 3 3
1 0 1 0 3 0 3 3 5 0 5 3
1 0 1 0 1 0 0 1 5 0 5 1
1 0 1 0 3 3 0 3 5 0 5 3
1 0 1 0 1 0 0 1 5 0 5 1
1 0 1 0 1 0 3 3 5 0 5 3
1 0 1 0 1 0 0 1 5 0 5 1
1 0 1 0 3 3 0 3 5 0 5 3
1 0 3 0 1 0 0 1 5 0 5 1
1 0 0 0 1 5 0 0 0 0 0 1
3 2 2 2 3 2 2 2 2 2 2 3