3 2 2 2 2 2 2 2 2 2 2 3
1 5 0 0 5 5 5 5 0 0 5 1
1 0 3 0 0 0 0 0 0 3 0 1
1 0 0 0 5 5 5 5 0 0 0 1
1 5 0 5 3 2 2 3 5 0 5 1
1 5 0 5 1 4 5 1 5 0 5 1
1 5 0 5 1 5 0 1 5 0 5 1
1 5 0 5 1 0 0 1 5 0 5 1
1 0 0 0 5 0 0 5 0 0 0 1
1 0 3 0 0 0 0 0 0 3 0 1
1 5 0 0 5 0 0 5 0 0 5 1
3 2 2 2 2 2 2 2 2 2 2 3