3 2 2 2 2 2 2 2 2 2 2 3
1 0 0 0 0 0 0 0 0 0 0 1
1 0 3 2 3 0 3 2 2 3 0 1
1 0 1 5 0 0 0 0 0 1 0 1
1 0 3 2 3 2 3 2 0 1 0 1
1 0 0 0 1 4 1 5 0 3 0 1
1 0 3 0 1 0 1 5 0 0 0 1
1 0 1 0 3 0 3 2 2 3 0 1
1 0 1 0 0 0 1 5 0 0 0 1
1 0 3 2 3 0 3 2 2 3 0 1
1 0 0 5 1 0 0 0 0 0 0 1
3 2 2 2 3 2 2 2 2 2 2 3