3 2 2 2 3 2 2 2 2 3 2 3
1 0 0 0 1 0 0 0 5 1 5 1
3 2 3 0 3 0 3 0 5 1 0 1
1 0 0 0 0 0 1 0 5 3 0 1
1 5 3 2 2 2 3 0 0 0 0 1
3 2 3 0 0 0 3 2 2 3 0 1
1 0 0 0 1 0 0 0 0 0 0 1
1 0 3 2 3 2 2 2 2 2 2 3
1 0 1 0 0 0 0 0 0 0 0 1
1 0 3 0 3 2 0 2 2 3 0 1
1 0 0 0 1 5 0 0 5 1 4 1
3 2 2 2 3 2 2 2 2 2 2 3